s%0,0%
----cccc--
---c--ccc-
--c--c---c
-cc--c---c
c-c--c---c
c-c---ccc-
c-c-----c-
c-c-----c-
-cc-----c-
--c--c--c-
---cc-cc--
e%0,0%